p,p,p,p,p,p,p,p
p,p,p,p,p,p,p,p
p,p,p,p,c,p,p,p
p,c,c,c,c,c,c,p
p,c,p,c,p,p,c,p
p,c,p,c,p,p,c,p
p,c,p,c,c,c,c,p
p,c,p,c,p,p,c,p
p,c,c,c,c,p,c,p
p,p,c,p,c,p,c,s
p,p,c,p,c,p,p,p
p,c,c,c,c,c,p,p
p,p,c,p,p,c,p,p
p,p,E,p,p,p,p,p
